25 14
XXXXXXXXXXXXXXXXXXXXXXXXX
XXXXXXXXXXXXXXXXXXXXXXXXX
XXXXXXXXXXXXXXXXXX...XXXX
XXXXXXXXXXXXX......e.XXXX
XXXXXXXXXXXXXdXXXX...XXXX
XXXXXXXXX.....aXXXXXXXXXX
XXXXXXXX.......XXXXXXXXXX
XXXXXXXX.XXXxyzXXXXXXXXXX
XX....tX...b.c.XXXXXXXXXX
XX.....XXXXXXX.XXXXXXXhXX
XX......pX...X.XXXXXXXXXX
XX.....XXX.X.X.XXXXXXXXXX
XX.........X...XXXXXXXXXX
XXXXXXXXXXXXXXXXXXXXXXXXX
player 0 p
objective 1 t
switch 2 c off
switch 3 h on
door 4 b 2
door 5 d 2 3
exit 6 e
spikes 7 x 0 1
spikes 8 y 0 1
spikes 9 z 0 1
timebox 10 a
