18 17
XXXXXXXX.XXXXXXXXX
XXXXXXXX.XXXXXXXXX
XXXXXXXX.XXXXXXXXX
...............XXX
XX.XXXXX.XXXXX....
X.XXXXXX.XXXXXXXX.
X.XXXXXX.XXXXXXXXX
X..XX......XXXXXXX
XX..XXXXXX....XXXX
XXX....XXXXXX..XXX
XXXXXXXXXXXXXX..XX
XX.....XXXXXXXX.XX
XX...............X
XX..X..XX.XXXXX.XX
XX.....XX...XXX.XX
XX.....XXXX.....XX
XXXXXXXXXXXXXXXXXX
