28 22
XXXXXXXXXXXXXXXXXXXXXXXXXXXX
XXXXXXXXX.......XXXXXXXXXXXX
XXXXXXXXX.......XXXXXXXXXXXX
XXXXXXXXX................XXX
XXXXXXXXX.......XXXXXXXX.XXX
XXXXXXXXX.......XXXXXXXX.XXX
XXXXXXXXX.......XXXXXXXX.XXX
XXXXXXXXX.......XXXXXXXX.XXX
XXXXXXXXXXXX.XXXXXXXXXXX.XXX
XXXXXXXXXXXX.XXXXXXXXXXX.XXX
XXXXX....................XXX
XXXXX.................XXXXXX
XXXXX..XXXXXXXXXX.XX..XXXXXX
XXXXX..X..........XX..XXXXXX
XXXXX..X.XXXXX.X.XXX..XXXXXX
XXXXX....X.....X...X..XXXXXX
XXXXX..XXX.XXXXXXXXX..XXXXXX
XXXXX.................XXXXXX
XXXXX.................XXXXXX
XXXXXXXXXXX..XXXXXXXXXXXXXXX
XXXXXXXXXXX..XXXXXXXXXXXXXXX
XXXXXXXXXXXXXXXXXXXXXXXXXXXX
player 0 170,70
objective 1 309.5,367.344
exit 2 250,30
enemy 3 190,410 190,410 190,410 310,290 190,290 310,410 190,350 310,350 250,270
enemy 4 249.25,354.958 249.25,354.958 310,350 190,350 310,410 250,270 310,290 190,410 190,290
enemy 5 190,290 190,290 248.125,220.635 120.26,74.4167 418.76,79.8854 486.99,367.25
enemy 6 310,410 310,410 310,410 190,290 310,350 310,290 190,350 250,270 190,410
timebox 7 370,130
