28 22
XXXXXXXXXXXXXXXXXXXXXXXXXXXX
XXXXXXXXXa.....dXXXXXXXXXXXX
XXXXXXXXX...t...XXXXXXXXXXXX
XXXXXXXXX.......XXXXXXXXXXXX
XXXXXXXXXe.....fXXXXXXXXXXXX
XXXXXXXXX.......XXXXXXXXXXXX
XXXXXXXXX.......XXXXXXXXXXXX
XXXXXXXXXc.....bXXXXXXXXXXXX
XXXXXXXXXXXXgXXXXXXXXXXXXXXX
XXXXXXXXXXXX.XXXXXXXXXXXXXXX
XXXXX.................XXXXXX
XXXXX.................XXXXXX
XXXXX..XXXXXXXXXX.XX..XXXXXX
XXXXX..X..........XX..XXXXXX
XXXXX..X.XXXXX.X.XXX..XXXXXX
XXXXX....X.....X..mX..XXXXXX
XXXXX..XXX.XXXXXXXXX..XXXXXX
XXXXX.................XXXXXX
XXXXX...p.............XXXXXX
XXXXXXXXXXX..XXXXXXXXXXXXXXX
XXXXXXXXXXX.qXXXXXXXXXXXXXXX
XXXXXXXXXXXXXXXXXXXXXXXXXXXX
player 0 p
objective 1 t
exit 2 q
enemy 3 a b c d e f g
enemy 4 f e d g b a c
enemy 5 c g d f a b e
enemy 6 d c f b e g a
timebox 7 m
